######## ########
#......###......###################
#......|.|........................# #######
#......###......################..# #.....#
######## ####|###              #..###..S..#
            #.#                #...|...S..#
            #.#                #..###.....#
            #.#                #..# #######
            #.#                #..#
            #.#                #..#
            #.#                #..#
            #.#                #..#
            #.#                #..#
#############|##################..#
#.............................|...#
#.@...........................|...#
#.............................#####
#................R............#
#.............................#
#.............................#
#...............S.............#
#.............................#
#.............................#
###############################