######## ########
#......###......###################
#......|.|........................# #######
#......###......################..# #.....#
######## ####|###              #..###..S..#
            #.#                #...|...S..#
            #.#                #..###.....#
            #.#                #..# #######
            #.#                #..#
            #.#                #..#
            #.#                #..#
            #.#                #..#
            #.#                #..#
#############|##################..#
#.............................|...#
#.............................|...#
#.............................#####
#.............................#
#...@.........................#
#.............................#
#.............................#
#.............................#
#.............................#
###############################