######## ########
#......###......#
#......|.|......#
#......###......#
######## ####|###
            #.#
            #.#
            #.#
            #.#
            #.#
            #.#
            #.#
            #.#
#############|#################
#.............................#
#.............................#
#.............................#
#.............................#
#.............................#
#.............................#
#.............................#
#.............................#
#.............................#
###############################
