########
#......########
#u...........|#
#......########
#......#
########