######## ########
#......###......###################
#.P....|.|........................# #######
#......###......################..# #.....#
######## ####|###              #..###.....#
            #.#                #...|......#
            #.#                #..###.....#
            #.#                #..# #######
            #.#                #..#
            #.#                #..#
            #.#                #..#
            #.#                #..#
            #.#                #..#
#############|##################..#
#.............................|...#
#.............................|...#
#.............................#####
#.............................#
#.............................#
#.............................#
#.............................#
#.............................#
#.............................#
###############################