######## ########
#......###......###################
#.@....|.|..R.....................# #######
#......###......################..# #.....#
######## ####|###              #..###..S..#
            #.#                #...|...S..#
            #.#                #..###.....#
            #.#                #..# #######
            #.#                #..#
            #.#                #..#
            #.#                #..#
            #.#                #..#
            #.#                #..#
#############|##################..#
#..........R..................|...#
#.............................|...#
#.............................#####
#........R.......S............#
#.............................#
#.............................#
#...............S.............#
#.............................#
#.............................#
###############################